1111111111111111111111111111111111
10E0000000000000C00000100000000001
1010000000100000101001100000110101
10000000001000000010011000111111C1
100000000C00C0P00000001001000000C1
100000000C00C000000000000100000001
1111111111111111111111111111111111