1111111111111111111111111111111111
10000000000E0000C00000C00000000001
1010010100100000101001000000110101
1010010010100000001001000000010101
10000000PC00C0000000000000000000C1
100000000C00C0000000000000000000C1
1111111111111111111111111111111111