1111111111
1000000001
1P000C00E1
1111111111
