1111111111111111111111111111111
1000000001000000000000000110001
100000000100000000000000000E001
100000P000000000C0000C000111111
1000000001000000000000000000001
1000000001000000000000000000001
1000000C0000000C000000000000001
1111111111111111111111111111111
