1111111111
1000E00001
1P000C01C1
1111111111
