1111111111
10000000E1
1P000C01C1
1111111111
